1111111111111111111
100100C0000C0000001
1000011111000000011make fclean
100011E000000000111
100C1110000C0011111
1P01C000000000000C1
1111111111111111111
