1111111111111111111
100100C0000C0000001
1000011111000000011
1P0011E000000000111
100C111000000011111
1111111111111111111