1111111111111111111
1001000000000000001
1000011111000000011
100011E000000000111
1000111000000011111
1P01000000000000001
1111111111111111111